%%%%%%%%%
%G..%G..%
%%%...%%%
%%o.....%
%%%%%.%.%
%%%%%.%.%
%%%%PG%.%
%%%%Go..%
%%%%%%%%%
%%%%%%%%%
