%%%%%%%%%%%%%%%%
%.o....o....%%%%
%.%%%%....%.%.%%
%........Go....%
%...%%.%%.%.%.%%
%o...%.o..G.P..%
%........o.%G.%%
%.......o.....%%
%%......%%%%%%%%
%%%%%%%%%%%%%%%%
