%%%%%%%%%%%
%P.o.....%%
%%%%ooo.o.%
%..o.....%%
%%%%..%%%.%
%%%%....%.%
%%%%...G.o%
%%%%%%%%%%%
