%%%%%%%%%%
%....%%%%%
%...%%%%%%
%.%%%.%%%%
%.....o..%
%G.PGG.%%%
%..%o.G%%%
%......%%%
%........%
%..%.....%
%.%%.....%
%.%%.....%
%........%
%........%
%.%%....%%
%.%%%%%%%%
%.......%%
%%%%%%%%%%
