%%%%%%%%%%%%%%%%%%
%.%..o....G..%%%%%
%o%%.....o...%%G%%
%.%%%oGoG..o....%%
%%%o..P..G...%%%%%
%%%%%%%%%%%%%%%%%%
