%%%%%%%%
%%%%%%%%
%%%%%%%%
%%%%%P%%
%.%%%%%%
%.G..%%%
%....%%%
%......%
%ooo..o%
%.%%G%%%
%..o.%%%
%%%%%%%%
