%%%%%%%%%%%%
%%%%%%%%%%%%
%%.....o.G.%
%%.%..%%%%%%
%%.....%%%%%
%%.%..o.%o%%
%%.%..o.%..%
%%.........%
%%.....o...%
%%.%.......%
%%.%..o....%
%%.%.......%
%%.%.%.%...%
%%.%P......%
%%..o......%
%%%........%
%%%%%%%%%%%%
%%%%%%%%%%%%
