%%%%%%%%%%%%%%%
%............%%
%%..%.%%...%.%%
%G.....o%%%%.%%
%.%...%.%%%%.%%
%.%%..%..%%..%%
%....P.......%%
%.............%
%%%%%.o.......%
%%%%%%%%%%%%%%%
