%%%%%%%%
%%..o.o%
%%%%.%G%
%%%.GP%%
%%%..%%%
%Go.G..%
%....%%%
%%....G%
%%%%.%%%
%%%..o.%
%%%%%%%%
