%%%%%%%%%%%%%%%%%%
%.........%%%%%%%%
%%%...%%%....o%%%%
%%%%%o...........%
%%%...........%%%%
%%%...G..oo..%%%%%
%%%%%.%%..%%.%P%%%
%%%o%.%%.G...%%%%%
%%...o........%%%%
%%%%%%%%%%%%%%%%%%
