%%%%%%%%%%
%G...G%.%%
%.....%.%%
%G.%%.%o%%
%..%%....%
%.....oo%%
%.....G.o%
%.......%%
%%.%..%.%%
%%.%..%.%%
%%..P....%
%%%%%%%%%%
