%%%%%%%%%%%%%%%%%%%%%%%%%%%
%%%%.....................%%
%.%..%%...............%%%%%
%................%........%
%.%.%%........o..G...G...%%
%..P....................%%%
%.%.%...G.......o.........%
%........................%%
%.%.%............o..%%%..%%
%.%%%....%%%...%.........%%
%.%%..................o...%
%.%%%.......%%%......%%%.%%
%........................%%
%G...................%%%.%%
%..o..o.............%%%%.%%
%%........................%
%%%%%%%%%%%%%%%%%%%%%%%%%%%
