%%%%%%%%%%%%%%%%%%%%%%%%
%o..................G..%
%.%........o..........%%
%.%%...............%%o%%
%o%%.%%...........%%%..%
%o...%%........o....PG.%
%.%................%%o%%
%%....................%%
%%%%%%%%.G%%%%%%%%%%%%%%
%%%%%%%%%%%%%%%%%%%%%%%%
