%%%%%%%%%%%%%%%%%%%
%................%%
%%................%
%...%%%...%%%%....%
%.P.%%%%....%%....%
%G%.%%.%%.%%%%....%
%....%.%%.%%%%....%
%.o...............%
%.................%
%%............%.%%%
%%%o%%.%%%%%.%%.%%%
%%%...........%%%%%
%%%%.............%%
%%%%%%%%%%%%%%%%%%%
