%%%%%%%%%%%%%
%GGoo....G..%
%.%%%P%%%%..%
%G.G%%%%.oo.%
%........o%%%
%%%%%%%%%%%%%
%%%%%%%%%%%%%
