%%%%%%%%%%%%%%%%%%%%%%%%%%%%
%%......%%%%%%%%%%%%%%%%%%%%
%%%%.................%.%.%%%
%%%...........%%%P%%%%.%...%
%%%%%%......G...o.G....G%%.%
%.%%%%...................o.%
%......%.%....%.........%%%%
%..........................%
%%%%%%%%%%%%%%%%%%%%%%%%%%%%
