%%%%%%%%%%%%%%%%%%%%%%%%%%%%%
%....o......o......o...%%%%%%
%%%%%%%%%%%.%.%%o%....o%%P%%%
%%%%%%%%%%..................%
%%%%......G............o..%%%
%%%%%%%%%%%%%%%%%%%%%%%%%%%%%
