%%%%%%%%%%%%%%%%%
%%%%oo......%%%%%
%%.%%..GoGo.P%.%%
%...G.o..G.o....%
%%%%%%%%%%%%%%%%%
