%%%%%%%%%%%%%%
%%%.........%%
%%....%%%%%..%
%%P...Goo....%
%%%.....%%%..%
%%%%.........%
%%%%%%%.G....%
%%%%%%%%%%%%%%
