%%%%%%%%%%%%%%%%%%%%%%%%%%%%%
%%..........................%
%....G..................%%%.%
%....G............%%%%%%%%%.%
%%.%%.%.%............%%%%%..%
%%G%.......................%%
%%....%....................%%
%%%.........G....o.....%%%.%%
%%%.....................%%.%%
%.......................%%.%%
%..o............o...%.%%%%.%%
%%G%%%%............%%.%%%%%%%
%%%...........P%%%%%%%%%%%%%%
%%%%%%%%%%%%%%%%%%%%%%%%%%%%%
