%%%%%%%%%%%%%%%%%%%%%%%%%%%%%%
%%%........................%%%
%%%.%%%%%o%%%%%%%...G.%.%%.%%%
%%%...................%.%%.%%%
%%%..................o.....%%%
%%%.............o..........%%%
%%%...%...%.%o.%%.%%%...G..%%%
%.%...%..%%.%..%............%%
%.....o.....................%%
%%%.........................%%
%..................G........%%
%%%.P.......%.%%....%.%%.%.%%%
%%%%......................o.%%
%%%%%%%%%%%.................%%
%%%%%%%%%%%%%%%%%%%%%.o.....%%
%%%%%%%%%%%%%%%%%%%%%%%%%%%%%%
