%%%%%%%%%%%%
%%%PG%%%%%%%
%%...G.o.%%%
%%.%.o.....%
%%..Goo...o%
%%%%%%%%%%%%
