%%%%%%%%%%%%%%%%%%%%%%%%%%%
%%%................%%%%%%%%
%%.%%..G....G............%%
%................P.......%%
%........................%%
%..........o.....G.......%%
%..%%....................%%
%G........................%
%..%%..o...%..%%%.%%%%%..%%
%..o..............%%%%%..%%
%..%%..%.%o%..%.%.%%%%%..%%
%%.%%...................o%%
%%.%%..%.%%%..%.%...%%%%.%%
%%.......%%...........G%.%%
%%%.%%...................%%
%%%..................%%%%%%
%%%%%%%%%%%%%%%%%%%%%%%%%%%
