%%%%%%%%%%%%%%%%%%%%%%%%%
%%%%%%%%%%%%%%%%%%%%%P%%%
%%%%G.....o............%%
%%%.....................%
%%%.%.%................%%
%%%......o...........%%%%
%%%%%%%%%%%%%%%%%%%%%%%%%
