%%%%%%%%
%%%%%%%%
%oGPG%%%
%%oGG.%%
%%%%%%%%
%%%%%%%%
%%%%%%%%
