%%%%%%%%%%
%%%...G%%%
%G%%.GPG.%
%Go.o.%%%%
%%%%%%%%%%
