%%%%%%%%%%%%%%%%%%%%%%%%%%%%%%
%%%%%%%%%....Go..............%
%%%%%%..............%%%%%.%%.%
%%...........................%
%%%.P.....................%..%
%%.Go........G.......o.o.....%
%.......oo..%.......Go..%%%%.%
%%%%%%%%%%%%%%%%%%%%%%%%%%%%%%
