%%%%%%%%%%%%%%%%%%%%%%
%%%%%%%%%o..........%%
%.........%.%%.%%.%%%%
%.%.......G.........%%
%.......o.......%.%%%%
%...................%%
%..............o.....%
%........P..........%%
%..................%.%
%.%..%%............%.%
%G%.....o............%
%.%%.%%.....o.......%%
%.%%.%%.%....%...%..%%
%.%%.%%.%%.......%..%%
%.%%..%........%.%..%%
%.........%%........%%
%%%%%%%%%%%%%%%%%%%%%%
%%%%%%%%%%%%%%%%%%%%%%
