%%%%%%%%%%%%
%%%%%....o.%
%........%.%
%.%........%
%...o.....o%
%.%PG....oo%
%%.o.......%
%..........%
%%%%%%%%%%%%
%%%%%%%%%%%%
