%%%%%%%%%%%%%%%%%%%%%%%%%%%
%..P.oo...................%
%%%..o............o..%%%..%
%.%%..%%..%%.%%.%.........%
%.%%....................%.%
%..............G..........%
%.%............o.....%%%%G%
%.%%.%%%%.%%.%%%%%%..%.%%.%
%.%%.%%%%...o...........%.%
%%%%%%.....G.%%........G..%
%%%%%%%%%%%%%%%%%%%%%%%%%%%
