%%%%%%%%%%%%%%%
%%%%%%%%%%%%%%%
%.....o.%%%%%%%
%%.%%%..%%.o..%
%%.%%..%%..%%%%
%G.o.....oo.%%%
%%%%%..%oo%%%%%
%%P%...%%o.%%%%
%%%%%%....%%%%%
%%%%%%%%%%%%%%%
