%%%%%%%%%%%%%%%%%%%%%%%
%%%%%%%%%%%.G..o......%
%.....o...........%%%%%
%..........%%%.%..%%%%%
%.....%....%%%.....P.%%
%...................o.%
%...........%%.....%..%
%...........%%....%%%.%
%.%.................%.%
%.%G..............%.%.%
%.................%%%.%
%%%...................%
%%%%%%.o..............%
%%%%%%.%%%%.%%.....%%.%
%%%..............%%.%%%
%...................%%%
%%%%%....o...%%%%%%%%%%
%%%%%%%%%%%%%%%%%%%%%%%
