%%%%%%%%%%%%%
%%oo........%
%%.o...G.%%%%
%%.oGG..G..%%
%%o.....o...%
%%%%%%%%%%%%%
%P%%.%%%%%%%%
%%%%%%%%%%%%%
