%%%%%%%%%%%%%%%%%%
%%%..............%
%G..%.......%%%%.%
%...o%%%%..o%%%%.%
%.%%.%%%%.%.%%%%.%
%.%%.%%%%.%o..oo.%
%%o...o...oP...%%%
%%%%%%%%%%%%%%%%%%
