%%%%%%%%%%%%%%%%%%%%%%%%%%%%%
%%%%%%%%%.....Go..G.........%
%................Po.........%
%........................%..%
%%%%%.%.%.%.%%o%..%.%%%..%..%
%G%%%.%.%o%.%%....%.G.......%
%.%%%.%.....G...........%%.%%
%....................o..%%.%%
%%%%%%%%%%%%%%%%%%%%%%%%%%%%%
%%%%%%%%%%%%%%%%%%%%%%%%%%%%%
