%%%%%%%%%%%%%%%%%%%%%%%%%%%
%%%%%%%%%.....%%......%%%%%
%........................%%
%%......................o%%
%%%..%%...G.......o......%%
%.%..%%..........%%%%%...%%
%.%..%%..................%%
%.%..%%..................%%
%.%......o...............%%
%.%............P..........%
%.%%.%%.....o............%%
%.%%.%%....%%......%%%%%.%%
%.%%.%%%%%................%
%................%.%%%%%.%%
%o................o.....o%%
%........................%%
%%%%................%%%%%%%
%%%%%%%%%%%%%%%%%%%%%%%%%%%
