%%%%%%%%%%%%%%%%%%%
%%%%%%%%%%%%%%%%%%%
%..............%%.%
%.....o.o.........%
%%.%.%%%.%..G..%%.%
%P.%.%%%.%..%..%%.%
%%.%o.%%..........%
%%.%..%%.%o.%..%%.%
%...G.%%..........%
%o.%..%..o%%......%
%%.%.Go...%%%.....%
%%................%
%%............o...%
%%%%%%%%%%%%%%%%%%%
%%%%%%%%%%%%%%%%%%%
