%%%%%%%%%%%%%%%%%%
%%%..o....G..%%%%%
%%%%.....o...%%G%%
%%%%%oGoG..o....%%
%%%o..P..G...%%%%%
%%%%%%%%%%%%%%%%%%
