%%%%%%%%%%%%%%%%%%%%%%%%%%
%%%%%%%%%%%%%%%%%%%%%%%%%%
%%.%%%%%%%%%%%%%%%%%%.%%%%
%%....o.............%.%%%%
%%..................%....%
%%o...o...o...o.....%.%%.%
%%................o......%
%%......G..o.............%
%%....%%%%%P%%%%.%%%.G.%.%
%%%.........%%%%.G.....%.%
%%%%..G.........o...%...%%
%%%%.%%%%%%%%%%..G.......%
%%%%%%%%%%%%%%%%%%%%%%%%%%
