%%%%%%%%%%%%%%%%
%%%%P%%%%%%%%%%%
%............%%%
%..%%.%.G......%
%......o.....%.%
%...%...%......%
%.........%%...%
%............%%%
%.....%%%.%%o%%%
%..............%
%.........%%%%%%
%%%%%%.%%%%%%%%%
%%%%%%%%%%%%%%%%
