%%%%%%%%%%%%
%%........o%
%%.%%%%%%%%%
%%.%...%..%%
%%.%o%.%.%%%
%P.....%.%%%
%%%%.G.o%%%%
%%%%%%%%%%%%
