%%%%%%%%%%%%%%%%%%%%%%%%%%
%..............o.........%
%o........G..........%%%.%
%.......................%%
%.%%%......G........%%%%%%
%.%%%.%%....%%....P.....%%
%...G..%%...%%......%%%.%%
%%.G.........G%%%.o......%
%%%.............%%%.....%%
%%%%%%%%%%%%%%%%%%%%%%%%%%
