%%%%%%%%%%%%%%%%%%%%%%%
%%%...G.............%%%
%.........P......%%..%%
%%%..............o...%%
%%%.o...........G%...%%
%%%.%%%%....G...o....%%
%%%G.........%%%%%%%%%%
%%%%%%%%%%%%%%%%%%%%%%%
