%%%%%%%%%%%%%%%%%%%%%%%%%%%%%%
%....................G..%%%%%%
%.%%............G............%
%.%%...................%%%%..%
%.%%....................%%%.o%
%.%%.........................%
%.%%%%.....%%...%%%%%....%%..%
%.G.......o............%.%%..%
%...............%%.%%..%.%%..%
%.%%%............%.%%..%.%...%
%......................%.%..o%
%..%%.%%...............%%%...%
%.%%%.P.....................G%
%.%%%..................G.....%
%%.......%%..................%
%%%%%%%%%%%%%%%%%%%%%%%%%%%%%%
