%%%%%%%%%%%%%%%%%%
%%%Go............%
%%.......%%%%%%%.%
%.G....%...%%%%..%
%..%....%%G%%%%..%
%...o......%%%%..%
%.....%%%..%%%%..%
%%..........o.%..%
%%.%..%%....%....%
%%....o.......o..%
%................%
%%.%G.%o.o..%%.%.%
%%.%..........o..%
%%%%...%%%..%%...%
%%%%.....G.....%P%
%%%%%%%%%%%%%%%%%%
