%%%%%%%%%
%G..%G..%
%%%...%%%
%%o.....%
%%%%%.%.%
%%%%%.%.%
%%%%P.%.%
%%%%.o.G%
%%%%%%%%%
%%%%%%%%%
