%%%%%%%%%%%
%%%%%%.%%%%
%........%%
%o%G.%.%.%%
%.......G%%
%.%..%.%.%%
%PG..%.%.%%
%%%......%%
%%%....%.%%
%%%%......%
%%....o%.%%
%%.%...%%%%
%%.%...%%%%
%.o.o...%%%
%%.%%%.%%%%
%%%%%%%%%%%
%%%%%%%%%%%
