%%%%%%%%%%%%%%%
%.....G.......%
%%.G..........%
%.............%
%%.G...%%.%.%%%
%%......%.%.%%%
%......G....%%%
%.......G...%%%
%%.o..oP.....%%
%%....%%%.....%
%%..%.%%%...%%%
%.............%
%%%%%%%%%%%%%%%
%%%%%%%%%%%%%%%
