%%%%%%%%%%%%%%%%%%%%%%%%%%%%
%%%%%%%%..........%%%%%%%%%%
%%%%.%%%..%%%%%.......%%%%%%
%%%%.o.%..%%%%.....%%%%%%%%%
%.........G...............%%
%%%%......................%%
%%%%.........%%%%%..%.%%%.%%
%%%%..%.........G.....%%%.%%
%..o.o..o.........o.......%%
%%..P...................G..%
%%%%%%%%%%%%%%%%%%%%%%%%%%%%
