%%%%%%%%%%%%%
%%%%%%%%%%%%%
%%%%%%.%P%%%%
%.........%%%
%.%%...G....%
%.......%%%%%
%.........%%%
%.%....o..%%%
%o%%.%o.%%.%%
%.%%.%..%%o%%
%%.........%%
%o.........%%
%%%%%%%%%%%%%
