%%%%%%%%%%%%%%%%%%%
%oG.GoG.......Go.%%
%%%%%%%%..o....%o%%
%...o..o...PoG%%%%%
%%%%%%%%%%%%%%%%%%%
