%%%%%%%%%%%%
%%%%%%%%%%%%
%%%....o..%%
%%......%..%
%G..o.%%%..%
%%G.oo.....%
%%%...%%%..%
%%%%..%%%..%
%%.........%
%%%o.....o.%
%%%..%...G%%
%...o......%
%%%%o..P.%%%
%%%%%%%%%%%%
