%%%%%%%%%%%%%%%%%%%%%%%%%%%%%
%...G......G........%%%%%%%%%
%%%%%%%%%%%...%%..%.%%%%%%%%%
%.%%.......................o%
%...%%%.%P%...%.....%%%%%.Go%
%%..............o...........%
%%%%%%......................%
%%%.....o.....o..........%..%
%%%%%%%..%..................%
%%%%%%%%%%%%%%%%%%%%%%%%%%%%%
