%%%%%%%%%%%%%
%G.o..oG%%%%%
%%%G%..o%%%%%
%%o....G.o..%
%%......%%P.%
%%..G...o.oo%
%%%%.%%%%%%%%
%%%%%%%%%%%%%
