%%%%%%%%%%%%%
%%oo.......P%
%%.o...G.%%%%
%%.oGG..G..%%
%%o.....o...%
%%%%%%%%%%%%%
%%%%%%%%%%%%%
%%%%%%%%%%%%%
