%%%%%%%%%%%%
%.G..o.%%%%%
%G%%%.%.%%%%
%.%%%.%.%%%%
%....G.o..%%
%%%.%%%.%%%%
%%%%%%..P%%%
%%%%%%%%%%%%
