%%%%%%%%%%%%%%%%%%%
%%%%%%%..o........%
%.......%%%.%%%%%%%
%.%.%%%.%%%.%%%%%%%
%.%.......%..%%%%%%
%.%........o......%
%..............%%.%
%.................%
%%%...%.%%%..%.%..%
%.%%...........%..%
%.....G...........%
%.%.%....%%.......%
%.........%%G%o%%o%
%%......P...o..%%%%
%%%%%%%%%%%%%%%%%%%
