%%%%%%%%%%%%%
%%%%%G......%
%%%%%...oG%o%
%%%%%....o%.%
%.%%%..%..%.%
%G%%%..%.%.%%
%.%%%..G...%%
%o%%%..o....%
%.%%PG.%.%%%%
%.......o..%%
%..o...%%%%%%
%%%%%%%%%%%%%
