%%%%%%%%%%%%%%%%%
%%%%%%%oo....%%%%
%%%%%....oo%o%%.%
%%%%%%.%...%.%..%
%%%%%%.%...%....%
%%%%%%.%G.......%
%%%......oG.....%
%%.........%%%%%%
%..o..P.......%%%
%....G.....%%.%%%
%%%%%%%%%..%%%%%%
%%%%%%%%%%%%%%%%%
