%%%%%%%%%%
%.%..o...%
%.%G%%%.%%
%.%o%...o%
%..%%.%.%%
%%G%..%..%
%%...%%%.%
%.%%%.%..%
%...%...%%
%.%P%.%..%
%.%...%%.%
%%..%..%.%
%..%%%..%%
%.%%%%%..%
%%%%%%%%%%
