%%%%%%%%%%%%%%%%%%
%..%%%...%.%...%%%
%%..%..%.....%..%%
%.%.%%%%.%.%%.%..%
%.%..G..%......%.%
%.P%.%%.%.%.%%%%.%
%%..%...%..%.....%
%..%%.%%o.%..%%%.%
%.%....%.%.%.%o..%
%..%G%.%..G%.%.%%%
%%..%..%.%%%.%.%.%
%.%.%.%%%....%.%.%
%.%.%..%..%%.%...%
%.o..%..G%.%%.%.%%
%.%%%.%%.%....%..%
%.%...%o%..%.%.%.%
%.%.%....%.%.%.%.%
%....%.%.G.%.....%
%%%%%%%%%%%%%%%%%%
