%%%%%%%%%%%%%%%%%%%
%o%.P%%%.....%..%.%
%..%..%..%%.%..%..%
%%..%...%.%...%..%%
%.G%..%%...%.%..%.%
%.%.o%...%.%...%..%
%o.%...%..%.%.%.%.%
%%.%%.%..%........%
%...G%.%%%.%%%%%%.%
%.%%.....oG%......%
%%%%%%%%%%%%%%%%%%%
