%%%%%%%%%%%%%%
%......%....%%
%%%.%%G.%%%..%
%..%...%...%.%
%.%..%%..%...%
%..%..%.%.%%.%
%%...%..%...%%
%..%%.G%%.%..%
%.%.%%....%%.%
%.%.o%.%.%.%.%
%..%...%%..%.%
%.%..%....%..%
%..%%P%%%%%%.%
%.%.G.....%Go%
%.%.%%%%%...%%
%...%....%.%%%
%%%%%.%.%...%%
%.....%...%..%
%%%%%%%%%%%%%%
