%%%%%%%%%%%%%
%...%...%%..%
%%.%..%..o.%%
%%..%..%.%..%
%.%.G%.%G%%.%
%.%.%..%...%%
%.%..%..%%..%
%..%..%...%.%
%%..%.P%.%o.%
%..%G%..%%.%%
%.%..o%....%%
%.%.%..%%%..%
%..o%.%...%.%
%.%.%...%...%
%%%%%%%%%%%%%
