%%%%%%%%%%%%%%%
%o.%....G...%.%
%%..%%.%.%%...%
%%%..G%%...%.%%
%%o%%...%%.%..%
%....%%.%...%.%
%.%%..%.%%%.%.%
%...%.%.....%.%
%.%..%.%%%%.%.%
%.%.%..%...%..%
%%%...%..%%..%%
%oP.%...%%..%.%
%.%%..%%...%..%
%G..%%...%%.%.%
%.%.G..%......%
%%%%%%%%%%%%%%%
