%%%%%%%%%%%%%%%%%
%.%..%...%.%..%.%
%.%%.G.%....%...%
%...%G%.%.%.%%.%%
%%%.%.%..%%..%..%
%.%...%%...%..%.%
%..%.%.%.%.%.%..%
%.%.%....%o%...%%
%o%P%.%%%%..%%.%%
%.....%...%.%%..%
%.%G%%%.%.%..o%.%
%..%....%.%.%.%.%
%%.%.%.%...%%.%.%
%%.%.%..%%%..o%.%
%..%..%.%...%.%.%
%%.%%%..%.%%.%..%
%.....%.%G.G..%.%
%.%.%....%.%%...%
%%%%%%%%%%%%%%%%%
