%%%%%%%%%%%%%
%.%.%%.o...%%
%.%oG..%%%..%
%..%%.%%..o%%
%%....%..%%.%
%.%%%%..%%..%
%.....%....%%
%.%%%..%%%..%
%.%.%.%..%%.%
%...%..%....%
%.%.%.%G.%%G%
%..%%..%...%%
%%.P.%...%..%
%%%%%%%%%%%%%
