%%%%%%%%%%%%%
%.%.........%
%o%%%%.%.%.%%
%.....%%o%..%
%%.%%.%...%.%
%.%G%.%.%%..%
%...%..%...%%
%.%.%.%..%G.%
%.%.%..%o.%.%
%.%..%.%%.%%%
%%.%.%..%.GP%
%.....%..%%.%
%.%G%%.%.%..%
%..%...%...%%
%.%..%..%%.%%
%.%.%..%%...%
%.%.%%.%..%.%
%....%...%..%
%%%%%%%%%%%%%
