%%%%%%%%%%%%
%.%%....o%.%
%G..%%%.%P.%
%%%.......%%
%..%%%%%%.%%
%%...o..%..%
%..%.%%oo%G%
%.%%...%.%.%
%.%.%%..%%.%
%.....%....%
%%%%%%%%%%%%
