%%%%%%%%%%%%
%..%.......%
%%G%.%.%.%.%
%..%%..%.%%%
%%...%%%...%
%.%%....%%.%
%.%.%%%.%..%
%..o..%P%%.%
%.%.%.G..o.%
%%%%%%%%%%%%
