%%%%%%%%%%%%%%
%..%.%.......%
%%G.P.%%o%.%.%
%.%%%.%...%..%
%.%...%.%.%.%%
%...%%..%%...%
%.%%%.%..%.%.%
%.%...%.%..%.%
%..%G%..%.%..%
%%.%...%..%%.%
%..%.%%..%...%
%.%o...%.%.%%%
%.%.%.%.G%.%.%
%..%G.%.%..%.%
%%.%%.%.%.%..%
%%...%..%..%.%
%..%...%%%...%
%%%%%%%%%%%%%%
