%%%%%%%%%%%%
%..%.%..G%.%
%%.%...%.%.%
%...%.%....%
%%o%..%.%.%%
%...%o%%...%
%.%.%...%%.%
%.%o.%%..%.%
%%.%...%.%G%
%...%P%..%.%
%.%%...%.%.%
%..%.%%..%.%
%%......%..%
%%%%%%%%%%%%
