%%%%%%%%%%%%%%
%....%.......%
%%.%.%.%%%%%%%
%.%%.%.%G..o.%
%....%...%%%.%
%.%%%.%.%..%.%
%.%.......%%.%
%..%%.%.%.%o.%
%%...%%.G%%.%%
%.%%o%..%...%%
%P.%.%.%..%..%
%%.%.%.%.%G%o%
%..%..%..G.%.%
%.%.%...%.%..%
%....%%%%%..%%
%%.%%...%..%%%
%.....%...%%%%
%%%%%%%%%%%%%%
