%%%%%%%%%%%%%%
%..%%...%%P..%
%%...%%....%G%
%.%%..%%.%%.o%
%...%o.%.%..%%
%.%..%...%.%.%
%.%%%.%.%%G..%
%.....o%..%%.%
%G%%.%...%%%.%
%.%..%.%..%..%
%..%..%..%%.%%
%%.G%.%.%...%%
%%.%..%%%.%%.%
%..%.%....%..%
%.%..%.%%%%.%%
%%..%%.%....%%
%..%.....%%..%
%%...%.%...%.%
%%%%%%%%%%%%%%
