%%%%%%%%%%%%%%%%%%%
%.%.%...%..%...%..%
%.%.%.%.G.%..%...%%
%.%...%%%..G%o.%..%
%..%.%...%.%%.%.%.%
%%..%..%..%%..%...%
%..%.o%%%P...%.%.%%
%.%%%..%.%%%%....%%
%..%..%.....%.%%%.%
%%..%.%.%%%%%..o%.%
%.%...%......%%...%
%.%%%%..%%%G%..%%.%
%....%G%..%...%%..%
%.%%.%...%.%%....%%
%..%.G.%.....%.%..%
%%%%%%%%%%%%%%%%%%%
