%%%%%%%%%%%%%%%%%
%.oo..%GG....%..%
%%%.%.%.%%%%...%%
%..%o.%%...%.%.%%
%%..%....%.%.%..%
%%%..%%%%..%%.%.%
%%..%%...%....%.%
%..%%G.%.P%.%.%.%
%.%...%.%..%%.%.%
%o..%....%......%
%%%%%%%%%%%%%%%%%
