%%%%%%%%%%%%%%%%%%
%.%..%%.%......%.%
%..%.....%.%%%...%
%%..%.%%.%...%%%.%
%.%G..%..o%%...%.%
%.%.%%.%.%..%.%..%
%..%..G%.%%...%.%%
%%..%.%%...%%%..%%
%%%.G.%.%%....%..%
%%..%.....%%%P%%.%
%..%..%%%%%.%....%
%.%..%%..G.o%%%%.%
%.%%.%..%%.%...%.%
%..%...%.....%...%
%%%%%%%%%%%%%%%%%%
