%%%%%%%%%%%%%
%.%..%....%.%
%.G%o..%%...%
%%..%.%.G%%.%
%.%..P%%....%
%..%.%.%o%.%%
%%.%.%...%%.%
%...%.o%%...%
%.%o%.%%..%.%
%.%......%..%
%%%%%%%%%%%%%
