%%%%%%%%%%
%...%.%..%
%%.%.o..%%
%..%.%%.%%
%P%..%.o.%
%.%%..%%%%
%...%....%
%%%.%%%%.%
%......oG%
%%%%%%%%%%
