%%%%%%%%%%%%%%%%%
%..%...o.%......%
%.%..%o%..%.%.%%%
%..%%%.%.%..%...%
%%P%...%..%..%%.%
%..%G%%.%..%..%.%
%.%...%..%..%.%.%
%.%%%.%%.%%..%%.%
%...%..%...%.%..%
%%%..%G%%.%%.%.%%
%..%.%..%.%..%.%%
%%...%%.%.%.%%..%
%%o%%G..%.%...%.%
%..%.G%%..%%%...%
%.%%.%..%....%%.%
%.....%...%%....%
%%%%%%%%%%%%%%%%%
