%%%%%%%%%%%%%%%%%%
%.%%..%....o...%%%
%.G.%...%%.%.%..%%
%%%.%.%%%G..%.%..%
%...%%...%.%..%%.%
%%G%...%.%.%.%...%
%..%.%%%...%...%%%
%.%..%..%%%.%.%..%
%G.%.%.%....%..%o%
%.%..%...%.%.%.%o%
%..%..%.%....%.%G%
%%.%%..%%%.%%%...%
%%...%..%..o..%.%%
%.%%..%.%.%%%.%..%
%...%.%.%...%.%.%%
%.%.....%.%.%.P..%
%%%%%%%%%%%%%%%%%%
