%%%%%%%%%%%%%%%%
%.%....%.%.....%
%.%.%%..G..%%.%%
%.%...%%%.%....%
%..%.%...%.%.%.%
%%.%%..%.%...%.%
%%....%..%o%..%%
%.%%%%..%...%o.%
%.%..%.%G.%.%.%%
%..%.%.%%..%...%
%%...%...%..%.%%
%..%.%%%.%%%%..%
%.%..G..P.....%%
%%%%%%%%%%%%%%%%
