%%%%%%%%%%%%
%.....%....%
%%%%%.%.%.%%
%.G.%.%.%.G%
%.%..o%..%.%
%..%.%P%%..%
%%..%.....%%
%.%...%%.%%%
%.%%%%.%..%%
%o.....G%..%
%.%.%.%..%.%
%.%o%%..%o.%
%.%...%.%.%%
%..%%.%%..%%
%%.%%....%.%
%....%.%%%.%
%.%%..%%...%
%...%....%.%
%%%%%%%%%%%%
