%%%%%%%%%%%%%
%..%.G%.....%
%%..%.%.%%%o%
%.%.%.%.%...%
%.%G%.%.%.%.%
%.%.%...%.%.%
%.%P%.%.%.%.%
%.%..%.%%.%.%
%..%......%G%
%%.o%%.%%%..%
%.%...%..%.%%
%.%.%...%%..%
%.%.%%.%..%.%
%.%..%.%%.%.%
%.%.%%..%.%.%
%.....%.....%
%%%%%%%%%%%%%
