%%%%%%%%%%%%%%%%%%%%%%%%%%%%%
%.....o....o..GP......%%%%%%%
%.........G.................%
%%%%%%%.G..................%%
%%%%%%%%%%%%%%%%%%%%%%%%%%%%%
