%%%%%%%%
%%..o.o%
%%%%.%G%
%%%..P%%
%%%..%%%
%Go.G..%
%....%%%
%%....G%
%%%%.%%%
%%%..o.%
%%%%%%%%
