%%%%%%%%%%%%%%%%%%%%%%%%%%%%%
%%....o....................P%
%%%..............G.o......%.%
%%%.......o.....%%%%.%%.%.%.%
%%%%%%%%..%.%%.%%%%%.%%%%%%%%
%%%%%%...................%%%%
%%%%%%%%%%%%%%%%%%%%%%%%%%%%%
