%%%%%%%%%%%%
%%%.G%%%%%%%
%%...G.o.%%%
%%.%.o.....%
%%..Goo...P%
%%%%%%%%%%%%
