%%%%%%%%%%%%%%%
%%%%%%%%%%%%%%%
%.....o.%%%%%%%
%%.%%%..%%.o..%
%%.%%..%%..%%%%
%G.o.....oo.%%%
%%%%%..%oo%%%%%
%%%%...%%o.%%%%
%%%%%%...P%%%%%
%%%%%%%%%%%%%%%
