%%%%%%%%%%%%%%%%%%%
%%%%..%..%%...%%%%%
%%%..............G%
%%%%....%%..%%.%%.%
%..G........o....o%
%.........G.......%
%..%.%..o%..%%....%
%..%%%............%
%..%%%............%
%...%%...%..%.....%
%%..%%...%..%%....%
%%..%%............%
%%.......%..%..%..%
%%..P..........%.%%
%...........%.%%.%%
%%%%%%.%%%.....%%%%
%%%%%%%%%%%%%%%%%%%
%%%%%%%%%%%%%%%%%%%
