%%%%%%%%%%%%%%%%%%%%%%%
%...o..........oo.....%
%.%..%o.%%%%%%%.......%
%.%.o%..%%%%.........%%
%.%.%%.%%%%%.%.%...P..%
%.%.%%o%%%.%........%%%
%..%%%.%............%%%
%......o............%%%
%............o.G....G%%
%%%%%%%%%%%%%%%%%%%%%%%
%%%%%%%%%%%%%%%%%%%%%%%
