%%%%%%%%%%
%%%...G%%%
%P%%...G.%
%.o.o%%%%%
%%%%%%%%%%
