%%%%%%%%%%%%%%%%%%%%%%%%%%%%
%.P...G...o.....o...o.%%%%%%
%%%%o....G.......o......G..%
%%%%%%............G.G.....%%
%%%%%%%%%%%%%%%%%%%%%%%%%%%%
