%%%%%%%%%%%%%%%
%............G%
%G%%%%.......%%
%.%%....%%%%%%%
%G%%.........%%
%.%%%%...G...%%
%.%.%%.P..%%o%%
%G%.%%.......%%
%.%........%%%%
%.%.%%.....%%%%
%.%....o....%%%
%.......%%..%%%
%%%...........%
%%%%%...%%%%%%%
%%%%%%%%%%%%%%%
