%%%%%%%%
%%%%%%%%
%oGP.%%%
%%o...%%
%%%%%%%%
%%%%%%%%
%%%%%%%%
