%%%%%%%%%%%%%%%%%%%%%%
%....P..........o%%%%%
%.%%%....%.%..%%.%%%.%
%.%%%.%%%........%%%.%
%.%..................%
%.%%.............%.%.%
%.%........%%.%.%....%
%.%..%..%%.%%.%.%..%.%
%....................%
%.%...........%.%....%
%....................%
%%%.%%..o............%
%%%.%%.%%%.%.........%
%%....G....o.........%
%%%..................%
%%%%%%%%%%%%%........%
%%%%%%%%%%%%%%%%%%%%%%
