%%%%%%%%%%%%%%%
%.....G.......%
%%.G.%%.%.%...%
%.............%
%%.G%%.%%.%.%%%
%%......%.%.%%%
%.%%.%%.%...%%%
%.......G...%%%
%%.o..oP.....%%
%%....%%%.....%
%%..%.%%%...%%%
%......G..%...%
%%%%%%%%%%%%%%%
%%%%%%%%%%%%%%%
