%%%%%%%%%%%
%%%...%..G%
%%..%%.o.%%
%%%..G.%%%%
%%%%....%%%
%%o.....G.%
%%.%.o%%%.%
%%....%%%o%
%%G...%%%.%
%%o..G%.%.%
%%.%..%...%
%..%.%....%
%%.P......%
%%..%.O%%.%
%%.%%%..%%%
%......%%%%
%%%%%%%%%%%
%%%%%%%%%%%
