%%%%%%%%
%%%%%%%%
%%%%%%%%
%%%%%%%%
%.%%%%%%
%.G..%%%
%....%%%
%.....P%
%ooo..o%
%.%%G%%%
%..o.%%%
%%%%%%%%
