%%%%%%%%%%%%%%%%%%%
%.....%%.%%%.....%%
%%................%
%...%%%...%%%%.%%.%
%.P.%%%%....%%....%
%G%.%%.%%.%%%%.%%.%
%....%.%%.%%%%....%
%.o.%.%%%%........%
%...%.%%%%..%%%...%
%%............%.%%%
%%%o%%.%%%%%....%%%
%%%..%..%%....%%%%%
%%%%..........G..%%
%%%%%%%%%%%%%%%%%%%
