%%%%%%%%%%%%%%%%%%%%%%%%%
%%%%.....o.....G.......%%
%.........o..G......o...%
%%.%%%..............%%%%%
%%.%%%...%....G........%%
%%%%%%%..P%%%%.%%%%%%%%%%
%%%%%%%....G..G...%%%%%%%
%%%%%%%%%%%%%%%%%%%%%%%%%
