%%%%%%%%%%%%%%%%%%%%%%%%%%%
%%%%....................%%%
%%G%.%%%%%..............%%%
%..........o......%..%...G%
%%...................%.%%.%
%%................Go......%
%..%.%%...................%
%...........G.............%
%.......o.............%%%.%
%%.................P......%
%%........................%
%%%%%%.........o..........%
%%%%%%%%.......%%%%%%%%%%%%
%%%%%%%%%%%%%%%%%%%%%%%%%%%
