%%%%%%%%%%
%%%%.....%
%%%%%%%%.%
%%..%%.%.%
%%..%%.%.%
%o.%%.%..%
%...%%.%.%
%.o......%
%%%%.%%.%%
%..o....o%
%%...%%%.%
%%%P.%%o.%
%%..o%.%.%
%..G.G..%%
%%%%%%%%%%
