%%%%%%%%%%%%%%%%%%%%%
%.....o............%%
%%%%....%%..%%%%%%.%%
%%%%%%..%%..%%%.%%.%%
%....G....o...o.....%
%G..........%%%.%..%%
%G...%....o........%%
%..%.%....%.G......%%
%...............%.P%%
%.....o%%%G.....%..%%
%..%.%.%%%%.%%%...%%%
%....o.......o.....%%
%..%%%%%...........%%
%%%%%%%%%%%%%%%%%%%%%
