%%%%%%%%%%%%%%%%%%%%%
%%......G...%%%%%%%%%
%%..................%
%%.............%%%..%
%%.%%%%...%...%%.%.%%
%%.%......%....%.%.%%
%%................o.%
%%...%%............%%
%%...%%............%%
%%...%%.............%
%...................%
%....%%......%..%...%
%.......P....%......%
%%..................%
%......%.%%.%..%%%..%
%%o.................%
%%.....%%%%%%%%%%%%%%
%%%%%%%%%%%%%%%%%%%%%
