%%%%%%%%
%...o.%%
%.%%%o%%
%..%%.%%
%..%oP%%
%o...o%%
%%.%%%%%
%%G%%.%%
%%G...o%
%%%.%%%%
%%%%%%%%
%%%%%%%%
