%%%%%%%%%%%%%%%%%%%%%%%%%%%%%%
%%%................P.........%
%%%.......G............%%%%G%%
%%%.%%..................%%%.%%
%%.............%%%...%%...%.%%
%%..%.......................%%
%%......G...................%%
%.........o...o.............%%
%............................%
%.%.....................%%..%%
%.%.%%......................%%
%...o...........o............%
%%%.%%........G...........o%%%
%%.......o..........o.%%%%.%%%
%%%.........................%%
%%%%%%%%%%%%%%%%%%%%%%%%%%%%%%
