%%%%%%%%%%%%%%%
%.....%......%%
%%..%.%%...%.%%
%G..%.o%%%%%.%%
%.%.%.%.%%%%.%%
%.%%..%..%%..%%
%....P.......%%
%..%%..%%..%.%%
%%%%%.o.......%
%%%%%%%%%%%%%%%
