%%%%%%%%%%%%%%%%%%
%......P..%%%%%%%%
%%%...%%%....o%%%%
%%%%%o...........%
%%%...........%%%%
%%%...G..oo..%%%%%
%%%%%.%%..%%.%%%%%
%%%o%.%%.G...%%%%%
%%...o........%%%%
%%%%%%%%%%%%%%%%%%
