%%%%%%%%%%%%
%%%%%%%%%%%%
%%%....o..%%
%%......%..%
%G..o.%%%..%
%%G.oo.....%
%%%...%%%..%
%%%%.%%%%..%
%%.........%
%%%o.%%..%.%
%%%..%...G%%
%...o.%%...%
%%%%o..P.%%%
%%%%%%%%%%%%
