%%%%%%%%%%%%%%%%%%%%%%%%%%
%%%%%...%%%%%%%%%%...%%%%%
%..%..%.%...%......%.%...%
%%.......................%
%%.%..%.%%G.%.%%%%.%...%.%
%%.........P...........%.%
%......o%%%%%%%%%%..G..%.%
%...%%%%%%%%%..........%.%
%........%%%%%%%%......%.%
%.%%%%%%...........%...%.%
%..........%%%.%%........%
%...%%%.%%...%%%%%%%%..%.%
%%...G.................%%%
%%%%%%%..%%%..%%%%.%%..%%%
%%%%%%%..%%%%.%%%%.%%..%%%
%%%%%%%........%%.o....%%%
%%%%%G....%%%%....%%%%%%%%
%%%%%%%%%%%%%%%%%%%%%%%%%%
