%%%%%%%%%%%%
%%%G.%%%%%%%
%.o...o%%%%%
%...%%%%.o%%
%..........%
%....%%%%..%
%..........%
%..%..%%%..%
%%.%....%..%
%%...P.....%
%%..%o%%...%
%%%%%%%%G..%
%....oG...%%
%%%%%%%%%%%%
