%%%%%%%%%%%%
%%.........%
%%.........%
%%......%..%
%%.....G%..%
%%%%....%..%
%%%%..o....%
%%%%..%.%%.%
%%%.....%%.%
%%%%%.%....%
%%%%%.%....%
%%%%%.%o.%%%
%G%%%.%..%%%
%........P%%
%%%%%%%%.%%%
%%%%%%%%%%%%
%%%%%%%%%%%%
