%%%%%%%%%%
%%%%%%%%%%
%%..%.%.%%
%.....o.%%
%.%.%%..%%
%........%
%%%.G...%%
%.%.%o%.%%
%.G...%G%%
%%%..P%.%%
%%..%%..%%
%%%%%%%%%%
%%%%%%%%%%
