%%%%%%%%%%
%%%%%%%%%%
%%%.%%%%%%
%%%.%%.o.%
%%%.%%G%.%
%%...%.%.%
%%Go...%.%
%%..%%.%.%
%%..%%.%.%
%G..%%.%.%
%..P..G..%
%%%%...G%%
%%%%%%%%%%
