%%%%%%%%%%%
%......o%%%
%%..%.%%%%%
%%..%.%%%.%
%G....%%..%
%.%%.oG...%
%Go....%.%%
%..%%%.P.%%
%G.......%%
%....%%%%%%
%%.%.%%%%%%
%%.%.%%%%%%
%%...%%%%%%
%%%%%%%%%%%
%%%%%%%%%%%
