%%%%%%%%%%%%%%%%%%%%%%%%%%%%%%
%%%%......G.....o.PG.G.%%%%%%%
%%...o...o...%.%.%%.%%%%%.%%%%
%%.%...%%%.%.%.%%%%%%.......%%
%%.o.......o..........o..G..%%
%%%%%%%%%%%%%%%%%%%%%%%%%%%%%%
