%%%%%%%%%%
%%%%%%%%%%
%%%%%%%%%%
%%......%%
%%..%....%
%%......o%
%.....%%.%
%.o......%
%.o...P..%
%...%.%%.%
%G.G..G..%
%.%....oG%
%.%%%.%%G%
%.%...%%.%
%........%
%%%%%%%%%%
%%%%%%%%%%
