%%%%%%%%%%%%%%%%%%%%%%%%%
%...G..%.........%......%
%.%%%.%.%.%%%%%%%.%.%%%.%
%O.................O....%
%.%%%.%%%.%%%G%%%.%%%.%%%
%............%..........%
%%%%%.%%%%%%.%.%%%%%%.%%%
%..G..............%.....%
%.%%%%%%%%.%.%%%%%%.%%%.%
%...........P.........O%%
%%%%%%%%%%%%%%%%%%%%%%%%%
