%%%%%%%%%%%%%%%%
%...%...P.%.%%.%
%%.%..%o%......%
%%.%%%.%..%%.%.%
%..G....%.%..%.%
%.%%%.%..%..%%.%
%%...%%.%..%...%
%oG%......%..%.%
%%%%%%%%%%%%%%%%
