%%%%%%%%%%%%%%%%%%%
%.%.G..%...G.%.%..%
%..%%.%..%.%%....%%
%%..%P.%.%....%%..%
%o%..%...%%%G%..%.%
%..%..%%....%..%..%
%.%.%...%%%...%..%%
%....%%...%.%..%..%
%%%%...%%..%.%..%.%
%....%.%..%.Go%.%.%
%.%%..%..%..%.%.%.%
%.%.%%%o%..%...%%.%
%.........%..%....%
%%%%%%%%%%%%%%%%%%%
