%%%%%%%%%%%%%%%%%
%.G.%...%.%%%...%
%.%GG%%....%..%.%
%%.%.%.%%%o..%..%
%..%.....%%%%%.%%
%.%%%%%%..o....%%
%..%....%.%%%%..%
%%.%.%.%%%...%%.%
%..%.%..%..%..%.%
%.%%.%%...%o%%..%
%...P..%%......%%
%%%%%%%%%%%%%%%%%
