%%%%%%%%%%%%%%%%%
%..%%........%..%
%%...%%.%%%.%..%%
%.%%..%...%...%.%
%...%.%%%.o%%.%.%
%.%.%.G..%.%..%.%
%%...%%%...%.%..%
%..%.%..%%%%..%.%
%.%..G%.%.o.%.%.%
%.%.%%.o..%%G.%.%
%..%.%.%%..%.%%.%
%%o..%.%..%%.%..%
%.%.%...%....%.%%
%G..P.%..%.%....%
%%%%%%%%%%%%%%%%%
