%%%%%%%%%%%
%P.....%.%%
%%%%.%.%..%
%...%..%%.%
%o%o.%....%
%.o%..%%%.%
%%.G%.....%
%%%%%%%%%%%
