%%%%%%%%%%
%...%....%
%%%...%%.%
%.%%%.%..%
%P...%.o%%
%.%%..%..%
%G.%%o%o%%
%%..%.%..%
%..%..%%.%
%o%G%..%.%
%....%...%
%%%%.%%%%%
%........%
%%%%%%%%%%
