%%%%%%%%%%%%%%%%%%%
%G..o%....%....%..%
%%%%..%.%...%%..%.%
%.P%%.%%..%%.%%...%
%.%..o.%.%%....%.%%
%o.G%%o..%..%%....%
%%%%%%%%%%%%%%%%%%%
