%%%%%%%%%%%%%%%
%.%..%%...%...%
%..%P...%G..%.%
%%.%.%.%%%.%..%
%%..%...%...%.%
%.%.%.%..%%.%.%
%.%..%%.%G..%.%
%.%%.o.%%.%%..%
%...%%.%..%..%%
%%.%.%...%.%G.%
%....%%%.%...%%
%.%%%...%..%%G%
%.%...%..%.%..%
%...%%.%....%.%
%.%....o%.%...%
%%%%%%%%%%%%%%%
