%%%%%%%%%%%%%
%P%o%.......%
%....%.%.%.%%
%%G%..%o.%.%%
%.%%%.%%.%..%
%..%%...%.%.%
%%....%.....%
%%%%%%%%%%%%%
