%%%%%%%%%%%
%.%%%oP...%
%..%..%.%.%
%%oo%.G%%.%
%%%..%%...%
%%%%..o.%.%
%%%%%%%%%%%
