%%%%%%%%%%%%%%%%%
%....%o....%....%
%.%.%Go%.%..%%%.%
%..%..%...%...%.%
%%.G%..%.%.%%...%
%.%.%%%..%...%%.%
%Po..o..%..%....%
%%%%%%%%%%%%%%%%%
