%%%%%%%%%%%%%%%%%
%......%%...%%..%
%%.%%%...%%....%%
%.%...%%.%%%.%..%
%...%.G%..%...%.%
%.%.%.%..%..%..%%
%%...%..%.o%.%.%%
%..%%..%%%.%.%..%
%%.%..%.%....%%.%
%.P%.%....%.%...%
%.%.o.%%%%.%..%.%
%G..%......G.%..%
%%%%%%%%%%%%%%%%%
