%%%%%%%%%%%%
%.%....%.%.%
%.%G%%G....%
%..%..%G%%.%
%%..%.....%%
%oo%..%%%..%
%.%.%.%..%.%
%.%.%o..%..%
%.%.%%.%..%%
%.%.oP..%.%%
%.%.%%%%...%
%..%....%%.%
%.%..%%.%%.%
%...%......%
%%%%%%%%%%%%
