%%%%%%%%%%%%%%%%%%%
%.%..%....%....%..%
%..%o..%.%..%%.%.%%
%%.%.%%G..P%.%.%..%
%..%%%o.%%%..%..%.%
%%.....%...%..%.%.%
%.%.%%%.%%..%.%...%
%..%......%.%..%%.%
%.%%G%G%%.....%...%
%....%..%.%%%.%%.%%
%.%%%.%..%..G%....%
%......%...%...%%.%
%%%%%%%%%%%%%%%%%%%
