%%%%%%%%%%%%%%%%
%.%....%%......%
%.o%.%....%.%.%%
%%G.%..%%%%.%.%%
%.%.%P%..G.%%..%
%.G..%.o%%...%.%
%o%%o.G%...%...%
%%%%%%%%%%%%%%%%
