%%%%%%%%%%%%%
%...%.....%.%
%%%.%.%.%...%
%.%..%..%.%.%
%..G%%.%o.%.%
%%.%...%.%..%
%Po.%.%.%..%%
%%.%..%.%G%.%
%....%......%
%%%%%%%%%%%%%
