%%%%%%%%%%%%%%%%%
%...%.G..%......%
%%%...%%...%.%%.%
%.P%%%.%%%%.%.%.%
%.%o.%..........%
%..%...%.%%%%%.%%
%%o..%%.%.....%.%
%..%o.G...%.%...%
%%%%%%%%%%%%%%%%%
