%%%%%%%%%%%%%%%%
%...%.....%..%.%
%%%...%%%.%%o..%
%..%%%..%..%%.%%
%.%%...%%%..%..%
%....%..%.%.o%.%
%G%.%%%...%.%%.%
%.%..%.%%.%....%
%..%..G.%%%%%.%%
%.%%%%%...%....%
%..%G..%%..%.%.%
%%..%%...%....%%
%%%....%.P%.%..%
%%%%%%%%%%%%%%%%
