%%%%%%%%%%%%%%%%%%%
%.%....%%.....%.%.%
%.%%.%....%%%.%...%
%.o%.%.%.%%o%.o%.%%
%%G%..%.%....%.%..%
%.G.%.%.G.%%.%.%.%%
%%.%.G%%.%...%.%..%
%..%.%...%%%.%..%.%
%.%..%.%....%..%..%
%..P%...%.%G..%..%%
%%.%..%.%..%%%..%.%
%%%..%...%%...%...%
%%..%.%%...%%...%.%
%..%....%%.%.%%%..%
%.%..%%.......o..%%
%%%%%%%%%%%%%%%%%%%
