%%%%%%%%%%%%%%%%%%%
%.%..%...%%...%.%.%
%.%%...%...G%.%...%
%...%.%%%.%%o.%%.%%
%%%.%..%..%.%.G%..%
%.%..%.%.%..%%.%%.%
%..%.%.%..%.......%
%.%%..%%%..%%%%%%.%
%...%..%..%......%%
%.%.%%..%...%%%%..%
%.%...%.%.%%.G.%%.%
%.%%.%...%%%.%....%
%..%..%%o%%..%%%%.%
%%..%.....PG%.....%
%%%%%%%%%%%%%%%%%%%
