%%%%%%%%%%%%%%%%%%
%....o.o%...%...%%
%%%.%%.%..%.%.%..%
%.%..%%..%.....%.%
%..%Po.%%..%%%%..%
%%.%%%...%%....%.%
%....GG%....%%...%
%%%%%%%%%%%%%%%%%%
