%%%%%%%%%%%%%%%
%..%.%...o%.%%%
%.%...%G%....%%
%...%..%..%%..%
%%%%.%..%...%.%
%....%%..%.%P.%
%%.%..%%..%..%%
%..%.%..o%G.%.%
%%.%.%G%%.%..o%
%...%..%.o.%%.%
%.%.%.%..%....%
%.%...%.%.%.%.%
%..%%%...G%.%.%
%%.%...%.%..%.%
%...%%%.%..%%.%
%.%.......%...%
%%%%%%%%%%%%%%%
