%%%%%%%%%%%%%%%%
%.%.....%..%G%.%
%...%%%..%..G..%
%%.%....%..%.%.%
%.%..%%%..%%%..%
%..%.%...%.%..%%
%%.%G..%%...%..%
%.o.%.%...%.%.%%
%.%..%.%%%..%..%
%..%...o...%o%.%
%%.o%.%.%.%..%.%
%%%..%..%...%%.%
%%%.%G.%.%.%...%
%%..%.%...%%.%%%
%..%....%P.....%
%%%%%%%%%%%%%%%%
