%%%%%%%%%%%%%
%.o.%...%...%
%%%.%.%%..%.%
%oP.%..%.%..%
%.%%.%...%%.%
%.%.oG%%%.o.%
%.G%%.....%.%
%%..%.%.%%..%
%%%..%..%%.%%
%%%%...%....%
%%%%%%%%%%%%%
