%%%%%%%%%%%%%%%%%%
%.%G.%%.G.%.%...%%
%..%....%....%%..%
%%.%.%%%%.%%.%.%.%
%%..%.G...%..%...%
%.%.%.%.%%%%.o%.%%
%.%...%%.o%.%....%
%..%%%...%...%%%.%
%%...%.%.%.%.....%
%%.%...%%..%G%.%%%
%..P%.%...%.%.%..%
%.%%.%..%.%....%.%
%......%....%%...%
%%%%%%%%%%%%%%%%%%
