%%%%%%%%%%%%%%%%%
%.%....%........%
%..%.%...%%%.%%.%
%.%..G%.%..G%...%
%.%%%.%..%.%%.%%%
%..G%.%%.%......%
%.%.%..%..%%%.%.%
%.%.%.%.%....%..%
%%..%....%%%.P%%%
%..%.%%.%...%...%
%.%....%..%.%%%.%
%.%.%%...%o..o%.%
%.....%.%..%%...%
%%%%%%%%%%%%%%%%%
