%%%%%%%%%%%%%%%%
%.%%........%..%
%...%G%.%.%..%.%
%%%..%...%..%..%
%..%...%%..%%.%%
%.%.%%%...%%P..%
%...%...%%...%.%
%.%.o%.%..%.%%.%
%o.%.%..%...%..%
%%Go%%G%.%.%..%%
%.%.%..%..o%%..%
%.....%.%.%..%.%
%.%%%%..G.%%.%.%
%.%...%%.%.%...%
%...%....%...%.%
%%%%%%%%%%%%%%%%
