%%%%%%%%%%%%%%%%%%
%.%......G.....%.%
%..%.%G%%%%.%%.%.%
%%GG%.....%..%...%
%.%.%.%.%o%.%.%%.%
%...P%%%..%.%..%.%
%.%%..%..%..%%...%
%...%..%%..%...%%%
%%.%G%..%.%%.%%..%
%ooo..%G..%.....%%
%%%%%%%%%%%%%%%%%%
