%%%%%%%%%%%%%
%..%Go...%..%
%%..%.%%...%%
%.o%..%.%%..%
%%o%.%P..%%.%
%..o.%.%....%
%%%%%%%%%%%%%
