%%%%%%%%%%
%G.%.....%
%%.%.%%.%%
%%P%.%...%
%..%.%.%.%
%%..%%o%.%
%.%....%.%
%.%%%.%%.%
%G...%.o.%
%.%%o.o%%%
%.%%%%%..%
%..%...%.%
%.%..%.%.%
%...%....%
%%%%%%%%%%
