%%%%%%%%%%%%%%%%
%.%.%.....%.%..%
%.%...%%%..G.G%%
%.%.%o..%%.%%.%%
%.%%.%.%...%...%
%..P.%.%.%%%.%.%
%%.%.%.%.%....%%
%.%..%.%.%%.%..%
%.%.%..%...%.%.%
%.%.o%..%%.%...%
%.%.%..%%%.%.%%%
%...%.%.%..%.%.%
%.%%...G%.%%.%G%
%..%.%%%%.%..%.%
%%.%%%....%%.%.%
%.....o%.%.....%
%%%%%%%%%%%%%%%%
