%%%%%%%%%%%
%..%.%.%G.%
%%.%....%.%
%o.%o%%...%
%.%%...%%.%
%.%..%.%%.%
%.%o%....%%
%.%.%%%%..%
%.G%.....%%
%%.%.%o%..%
%..%P.%%%.%
%%..%..%..%
%.%.%.%..%%
%.....%.%%%
%%%%%%%%%%%
