%%%%%%%%%%%%%%%%%%%
%.%o...%...G%%%...%
%.%%.%%..%%..%..%.%
%..%.GG.%%.%.%.%..%
%%.%.%o%...%.%..%.%
%..%%..%%.%...%.%%%
%.%...%.%.%.%.%...%
%.%.%.%...%..%..%.%
%..%..%.%..%..%%..%
%%G%.%%%%.%%%.%..%%
%..%..%....%..%.%.%
%.%%.%..%%%..%....%
%.%..%.%%...%P.%%.%
%...%.....%...%...%
%%%%%%%%%%%%%%%%%%%
