%%%%%%%%%%%%%%%%
%.%....%%......%
%.o%.%....%.%.%%
%%..%..%%%%.%.%%
%.%.%P%....%%..%
%.G..%.o%%...%.%
%o%%o.G%...%...%
%%%%%%%%%%%%%%%%
