%%%%%%%%%%%%%%%
%...%.%%......%
%%%.%....%%%.%%
%.%.%.%.%.....%
%.%.%%%%..%%G%%
%.%...%..%.%o.%
%.%%%.%.%%...%%
%...%.%...%%..%
%.%.P.%.%G..%.%
%%..%%..%.%..%%
%.G%%%.%.%.%..%
%%..%....o.%%.%
%.%..%.%%%%...%
%..%.%%.G...%.%
%.%%....%%%..%%
%...%%%%...%..%
%.%.%....%%.%.%
%.%...%%......%
%%%%%%%%%%%%%%%
